1111111111111111111111111111111111
1E00000000000000C00000000000100001
1100110100100000101001000000010101
1P10110010101010001001000000010101
100C1CCCCCCCCCCCCCCCCCCCCCCCCCCCC1
1111111111111111111111111111111111
